Urb, Urb, Urb, Urb, Urb, Urb, Urb, Urb, Urb, Urb
Urb, Urb, Ha, Urb, Ha, Urb, Ha, Urb, Ha, Urb
Urb, Ha, Urb, Ha, Urb, Ha, Urb, Ha, Urb, Urb
Urb, Urb, Ha, Urb, Ha, Urb, Ha, Urb, Ha, Urb
Urb, Ha, Urb, Ha, Urb, Ha, Urb, Ha, Urb, Urb
Urb, Urb, Ha, Urb, Ha, Urb, Ha, Urb, Ha, Urb
Urb, Ha, Urb, Ha, Urb, Ha, Urb, Ha, Urb, Urb
Urb, Urb, Ha, Urb, Ha, Urb, Ha, Urb, Ha, Urb
Urb, Ha, Urb, Ha, Urb, Ha, Urb, Ha, Urb, Urb
Urb, Urb, Urb, Urb, Urb, Urb, Urb, Urb, Urb, Urb
